##A ####
#   ####
##   ###
### # ##
# ##   #
####   #
#  ##B## 